22,30
113,110,100,100,100,100,100,100,100,100,100,100,100,100,100,100,100,100,100,100,100,100,100,100,100,100,100,100,120,123
110,110,100,100,100,100,100,100,100,100,100,100,100,100,100,100,100,100,100,100,100,100,100,100,100,100,100,100,120,120
100,100,100,100,100,100,100,100,100,100,100,100,100,100,100,100,100,100,100,100,100,100,100,100,100,100,100,100,100,100
100,100,100,100,101,101,101,101,101,101,101,100,100,100,100,100,100,100,100,101,101,101,101,101,101,101,100,100,100,100
100,100,100,100,100,100,100,101,100,100,100,100,100,100,100,100,100,100,100,101,100,100,100,100,100,100,100,100,100,100
100,100,100,100,100,100,100,101,100,100,100,100,100,100,100,100,100,100,100,101,100,100,100,100,100,100,100,100,100,100
100,100,100,100,100,100,100,101,100,100,100,100,100,100,100,100,100,100,100,101,100,100,100,100,100,100,100,100,100,100
100,100,100,100,100,100,100,101,100,100,100,100,100,100,100,100,100,100,100,101,101,101,101,101,101,101,100,100,100,100
100,100,100,100,100,100,100,101,100,100,100,100,100,100,100,100,100,100,100,100,100,100,100,100,100,101,100,100,100,100
100,100,100,100,100,100,100,101,100,100,100,100,100,100,100,100,100,100,100,100,100,100,100,100,100,101,100,100,100,100
100,100,100,100,101,101,101,101,101,101,101,100,100,100,100,100,100,100,100,101,101,101,101,101,101,101,100,100,100,100
100,100,100,100,100,100,100,100,100,100,100,100,100,100,100,100,100,100,100,100,100,100,100,100,100,100,100,100,100,100
130,130,100,100,100,100,100,100,100,100,100,100,100,100,100,100,100,100,100,100,100,100,100,100,100,100,100,100,140,140
133,130,100,100,100,100,100,100,100,100,100,100,100,100,100,100,100,100,100,100,100,100,100,100,100,100,100,100,140,143
000,000,000,000,000,000,000,000,000,000,000,000,000,000,000,000,000,000,000,000,000,000,000,000,000,000,000,000,000,000
000,000,000,000,000,000,000,000,000,000,000,000,000,000,000,000,000,000,000,000,000,000,000,000,000,000,000,000,000,000
000,000,000,000,000,000,000,000,000,000,000,000,000,000,000,000,000,000,000,000,000,000,000,000,000,000,000,000,000,000
000,000,000,000,000,000,000,000,000,000,000,000,000,000,000,000,000,000,000,000,000,000,000,000,000,000,000,000,000,000
000,000,000,000,000,000,000,000,000,000,000,000,000,000,000,000,000,000,000,000,000,000,000,000,000,000,000,000,000,000
000,000,000,000,000,000,000,000,000,000,000,000,000,000,000,000,000,000,000,000,000,000,000,000,000,000,000,000,000,000
000,000,000,000,000,000,000,000,000,000,000,000,000,000,000,000,000,000,000,000,000,000,000,000,000,000,000,000,000,000
000,000,000,000,000,000,000,000,000,000,000,000,000,000,000,000,000,000,000,000,000,000,000,000,000,000,000,000,000,000